33, 33, 33, 33, 9, 33, 33, 33, 33
0, 0, 0, 0, 1, 0, 0, 0, 0
0, 0, 0, 0, 9, 0, 0, 0, 0
0, 0, 0, 0, 1, 0, 0, 0, 0
0, 0, 0, 0, 1, 0, 0, 0, 0
0, 0, 0, 0, 9, 0, 0, 0, 0
0, 0, 0, 0, 1, 0, 0, 0, 0
0, 0, 0, 0, 1, 0, 0, 0, 0